WWWWWWWWWW
W   S    W
WBBBBBBB W
W        W
W BBBBBBBW
W        W
WBBBBBBB W
W        W
W WWWWWWWW
W       GW
WWWWWWWWWW
